00000000000000000000
01111111111111111110
01111111111111121110
01111110111101111110
01111110111101111110
01111110112111111110
01111111111101111110
01111210101001111110
01111111111111111310
00000000000000000000
