00000000000000000000
01111111110111111110
01111111110111111110
01111110111110111110
01121110103010112110
01111110111110111110
01111111111111111110
01111111100011111110
01111111112111111110
00000000000000000000
