00000000000000000000
01111111111111111110
01111110000001111110
01111110111101111110
01112110113101112110
00000000111101100110
01111111112101111110
01111000000001111110
01211111111111111110
00000000000000000000
