00000000000000000000
01110111111111111110
01110011131111111110
01111000111101112110
01111210111101111110
01111110122101111110
01111000000001112110
01111011121101111110
01111111111111111110
00000000000000000000
