00000000000000000000
01111111111121111110
01111211111111111110
01111110111101112110
01111110112101111110
01111110111101111110
01112110111101112110
01111111111111111110
01111111112112111310
00000000000000000000
